[jenkins_jobs.publishers]
jira = jenkins_jobs.modules.publishers:jira
testng = jenkins_jobs.modules.publishers:testng
tap = jenkins_jobs.modules.publishers:tap
checkstyle = jenkins_jobs.modules.publishers:checkstyle
claim-build = jenkins_jobs.modules.publishers:claim_build
ruby-metrics = jenkins_jobs.modules.publishers:ruby_metrics
artifact-deployer = jenkins_jobs.modules.publishers:artifact_deployer
build-publisher = jenkins_jobs.modules.publishers:build_publisher
robot = jenkins_jobs.modules.publishers:robot
description-setter = jenkins_jobs.modules.publishers:description_setter
performance = jenkins_jobs.modules.publishers:performance
coverage = jenkins_jobs.modules.publishers:coverage
email-ext = jenkins_jobs.modules.publishers:email_ext
jabber = jenkins_jobs.modules.publishers:jabber
archive = jenkins_jobs.modules.publishers:archive
github-notifier = jenkins_jobs.modules.publishers:github_notifier
ftp = jenkins_jobs.modules.publishers:ftp
sitemonitor = jenkins_jobs.modules.publishers:sitemonitor
git = jenkins_jobs.modules.publishers:git
trigger = jenkins_jobs.modules.publishers:trigger
plot = jenkins_jobs.modules.publishers:plot
warnings = jenkins_jobs.modules.publishers:warnings
cloverphp = jenkins_jobs.modules.publishers:cloverphp
blame-upstream = jenkins_jobs.modules.publishers:blame_upstream
copy-to-master = jenkins_jobs.modules.publishers:copy_to_master
campfire = jenkins_jobs.modules.publishers:campfire
workspace-cleanup = jenkins_jobs.modules.publishers:workspace_cleanup
groovy-postbuild = jenkins_jobs.modules.publishers:groovy_postbuild
cppcheck = jenkins_jobs.modules.publishers:cppcheck
violations = jenkins_jobs.modules.publishers:violations
postbuildscript = jenkins_jobs.modules.publishers:postbuildscript
cobertura = jenkins_jobs.modules.publishers:cobertura
fitnesse = jenkins_jobs.modules.publishers:fitnesse
cifs = jenkins_jobs.modules.publishers:cifs
ircbot = jenkins_jobs.modules.publishers:ircbot
emotional-jenkins = jenkins_jobs.modules.publishers:emotional_jenkins
xml-summary = jenkins_jobs.modules.publishers:xml_summary
trigger-parameterized-builds = jenkins_jobs.modules.publishers:trigger_parameterized_builds
cigame = jenkins_jobs.modules.publishers:cigame
ssh = jenkins_jobs.modules.publishers:ssh
post-tasks = jenkins_jobs.modules.publishers:post_tasks
aggregate-tests = jenkins_jobs.modules.publishers:aggregate_tests
fingerprint = jenkins_jobs.modules.publishers:fingerprint
sloccount = jenkins_jobs.modules.publishers:sloccount
text-finder = jenkins_jobs.modules.publishers:text_finder
html-publisher = jenkins_jobs.modules.publishers:html_publisher
pipeline = jenkins_jobs.modules.publishers:pipeline
doxygen = jenkins_jobs.modules.publishers:doxygen
maven-deploy = jenkins_jobs.modules.publishers:maven_deploy
scp = jenkins_jobs.modules.publishers:scp
junit = jenkins_jobs.modules.publishers:junit
stash = jenkins_jobs.modules.publishers:stash
email = jenkins_jobs.modules.publishers:email
clone-workspace = jenkins_jobs.modules.publishers:clone_workspace
sonar = jenkins_jobs.modules.publishers:sonar
xunit = jenkins_jobs.modules.publishers:xunit
jacoco = jenkins_jobs.modules.publishers:jacoco
logparser = jenkins_jobs.modules.publishers:logparser
join-trigger = jenkins_jobs.modules.publishers:join_trigger

[jenkins_jobs.projects]
freestyle = jenkins_jobs.modules.project_freestyle:Freestyle
maven = jenkins_jobs.modules.project_maven:Maven
flow = jenkins_jobs.modules.project_flow:Flow
matrix = jenkins_jobs.modules.project_matrix:Matrix
multijob = jenkins_jobs.modules.project_multijob:MultiJob

[jenkins_jobs.modules]
scm = jenkins_jobs.modules.scm:SCM
publishers = jenkins_jobs.modules.publishers:Publishers
zuul = jenkins_jobs.modules.zuul:Zuul
parameters = jenkins_jobs.modules.parameters:Parameters
triggers = jenkins_jobs.modules.triggers:Triggers
general = jenkins_jobs.modules.general:General
notifications = jenkins_jobs.modules.notifications:Notifications
wrappers = jenkins_jobs.modules.wrappers:Wrappers
reporters = jenkins_jobs.modules.reporters:Reporters
hipchat = jenkins_jobs.modules.hipchat_notif:HipChat
builders = jenkins_jobs.modules.builders:Builders
properties = jenkins_jobs.modules.properties:Properties
metadata = jenkins_jobs.modules.metadata:Metadata

[jenkins_jobs.triggers]
github = jenkins_jobs.modules.triggers:github
script = jenkins_jobs.modules.triggers:script
gerrit = jenkins_jobs.modules.triggers:gerrit
github-pull-request = jenkins_jobs.modules.triggers:github_pull_request
pollscm = jenkins_jobs.modules.triggers:pollscm
build-result = jenkins_jobs.modules.triggers:build_result
timed = jenkins_jobs.modules.triggers:timed

[jenkins_jobs.metadata]
date = jenkins_jobs.modules.metadata:date_metadata
number = jenkins_jobs.modules.metadata:number_metadata
string = jenkins_jobs.modules.metadata:string_metadata

[jenkins_jobs.scm]
repo = jenkins_jobs.modules.scm:repo
svn = jenkins_jobs.modules.scm:svn
git = jenkins_jobs.modules.scm:git
workspace = jenkins_jobs.modules.scm:workspace
tfs = jenkins_jobs.modules.scm:tfs

[console_scripts]
jenkins-jobs = jenkins_jobs.cmd:main

[jenkins_jobs.properties]
least-load = jenkins_jobs.modules.properties:least_load
github = jenkins_jobs.modules.properties:github
throttle = jenkins_jobs.modules.properties:throttle
priority-sorter = jenkins_jobs.modules.properties:priority_sorter
build-blocker = jenkins_jobs.modules.properties:build_blocker
extended-choice = jenkins_jobs.modules.properties:extended_choice
heavy-job = jenkins_jobs.modules.properties:heavy_job
batch-tasks = jenkins_jobs.modules.properties:batch_tasks
zeromq-event = jenkins_jobs.modules.properties:zeromq_event
promoted-build = jenkins_jobs.modules.properties:promoted_build
delivery-pipeline = jenkins_jobs.modules.properties:delivery_pipeline
builds-chain-fingerprinter = jenkins_jobs.modules.properties:builds_chain_fingerprinter
copyartifact = jenkins_jobs.modules.properties:copyartifact
ownership = jenkins_jobs.modules.properties:ownership
slave-utilization = jenkins_jobs.modules.properties:slave_utilization
authenticated-build = jenkins_jobs.modules.properties:authenticated_build
authorization = jenkins_jobs.modules.properties:authorization
inject = jenkins_jobs.modules.properties:inject

[jenkins_jobs.builders]
critical-block-start = jenkins_jobs.modules.builders:critical_block_start
maven-target = jenkins_jobs.modules.builders:maven_target
msbuild = jenkins_jobs.modules.builders:msbuild
trigger-builds = jenkins_jobs.modules.builders:trigger_builds
sbt = jenkins_jobs.modules.builders:sbt
python = jenkins_jobs.modules.builders:python
inject = jenkins_jobs.modules.builders:inject
grails = jenkins_jobs.modules.builders:grails
batch = jenkins_jobs.modules.builders:batch
gradle = jenkins_jobs.modules.builders:gradle
ant = jenkins_jobs.modules.builders:ant
builders-from = jenkins_jobs.modules.builders:builders_from
shining-panda = jenkins_jobs.modules.builders:shining_panda
shell = jenkins_jobs.modules.builders:shell
copyartifact = jenkins_jobs.modules.builders:copyartifact
conditional-step = jenkins_jobs.modules.builders:conditional_step
artifact-resolver = jenkins_jobs.modules.builders:artifact_resolver
multijob = jenkins_jobs.modules.builders:multijob
critical-block-end = jenkins_jobs.modules.builders:critical_block_end

[jenkins_jobs.notifications]
http = jenkins_jobs.modules.notifications:http_endpoint

[jenkins_jobs.reporters]
email = jenkins_jobs.modules.reporters:email

[jenkins_jobs.parameters]
password = jenkins_jobs.modules.parameters:password_param
string = jenkins_jobs.modules.parameters:string_param
validating-string = jenkins_jobs.modules.parameters:validating_string_param
svn-tags = jenkins_jobs.modules.parameters:svn_tags_param
text = jenkins_jobs.modules.parameters:text_param
dynamic-choice = jenkins_jobs.modules.parameters:dynamic_choice_param
choice = jenkins_jobs.modules.parameters:choice_param
dynamic-choice-scriptler = jenkins_jobs.modules.parameters:dynamic_choice_scriptler_param
bool = jenkins_jobs.modules.parameters:bool_param
file = jenkins_jobs.modules.parameters:file_param
dynamic-string = jenkins_jobs.modules.parameters:dynamic_string_param
dynamic-string-scriptler = jenkins_jobs.modules.parameters:dynamic_string_scriptler_param
label = jenkins_jobs.modules.parameters:label_param

[jenkins_jobs.wrappers]
build-user-vars = jenkins_jobs.modules.wrappers:build_user_vars
locks = jenkins_jobs.modules.wrappers:locks
delivery-pipeline = jenkins_jobs.modules.wrappers:delivery_pipeline
ci-skip = jenkins_jobs.modules.wrappers:ci_skip
pathignore = jenkins_jobs.modules.wrappers:pathignore
mask-passwords = jenkins_jobs.modules.wrappers:mask_passwords
exclusion = jenkins_jobs.modules.wrappers:exclusion
matrix-tie-parent = jenkins_jobs.modules.wrappers:matrix_tie_parent
inject = jenkins_jobs.modules.wrappers:inject
sauce-ondemand = jenkins_jobs.modules.wrappers:sauce_ondemand
timestamps = jenkins_jobs.modules.wrappers:timestamps
workspace-cleanup = jenkins_jobs.modules.wrappers:workspace_cleanup
copy-to-slave = jenkins_jobs.modules.wrappers:copy_to_slave
pre-scm-buildstep = jenkins_jobs.modules.wrappers:pre_scm_buildstep
release = jenkins_jobs.modules.wrappers:release
ansicolor = jenkins_jobs.modules.wrappers:ansicolor
build-name = jenkins_jobs.modules.wrappers:build_name
port-allocator = jenkins_jobs.modules.wrappers:port_allocator
jclouds = jenkins_jobs.modules.wrappers:jclouds
logstash = jenkins_jobs.modules.wrappers:logstash
inject-passwords = jenkins_jobs.modules.wrappers:inject_passwords
rvm-env = jenkins_jobs.modules.wrappers:rvm_env
timeout = jenkins_jobs.modules.wrappers:timeout
env-file = jenkins_jobs.modules.wrappers:env_file
rbenv = jenkins_jobs.modules.wrappers:rbenv

